2 2 2 2 2 2 2 2 2 2 2 2 2 2 2 2 2 2 2 2 2 2 2 2 2 2 2 2 2 2 2 2 2 2 2 2 2 2 2 2 2 2 2 2 2 2 2 2 2 2 2 2 2 2 2 2 2 2 2 2 2 2 2 2 2 2 2 2 2 2 2 2 2 2 2 2 2 2 2 2 2 2 2 2 2 2 2 2 2 2 2 2 2 2 2 2 2 2 2 2 2 2 2 2 2 2 2 2 2 2 2 2 2 2 2 2 2 2 2 2 
2 2 2 2 2 2 2 2 2 2 2 2 2 2 2 2 2 2 2 2 2 2 2 2 2 2 2 2 2 2 2 2 2 2 2 2 2 2 2 2 2 2 2 2 2 2 2 2 2 2 2 2 2 2 2 2 2 2 2 2 2 2 2 2 2 2 2 2 2 2 2 2 2 2 2 2 2 2 2 2 2 2 2 2 2 2 2 2 2 2 2 2 2 2 2 2 2 2 2 2 2 2 2 2 2 2 2 2 2 2 2 2 2 2 2 2 2 2 2 2 
2 2 2 2 2 2 2 2 2 2 2 2 2 2 2 2 2 2 2 2 2 2 2 2 2 2 2 2 2 2 2 2 2 2 2 2 2 2 2 2 2 2 2 2 2 2 2 2 2 2 2 2 2 2 2 2 2 2 2 2 2 2 2 2 2 2 2 2 2 2 2 2 2 2 2 2 2 2 2 2 2 2 2 2 2 2 2 2 2 2 2 2 2 2 2 2 2 2 2 2 2 2 2 2 2 2 2 2 2 2 2 2 2 2 2 2 2 2 2 2 
2 2 3 4 4 4 4 4 4 4 4 4 4 4 4 4 4 4 4 4 4 4 4 4 4 4 4 4 4 4 4 4 4 4 4 4 4 4 4 4 4 4 4 4 4 4 4 4 4 4 4 4 4 4 4 4 4 4 4 4 4 4 4 4 4 11 11 11 11 11 11 11 11 11 11 11 11 11 11 11 11 12 2 2 2 2 2 2 2 2 2 2 2 2 2 2 2 2 2 2 2 2 2 2 2 2 2 2 2 2 2 2 2 2 2 2 2 2 2 2 
2 2 18 0 0 0 0 0 0 0 0 0 0 0 0 0 0 0 0 0 0 0 0 0 0 0 0 0 0 0 0 0 0 0 0 0 0 0 0 0 0 0 0 0 0 0 0 0 0 0 0 0 0 0 0 0 0 0 0 0 0 0 0 0 0 0 0 0 0 0 0 0 0 0 0 0 0 0 0 0 0 27 2 2 2 2 2 2 2 2 2 2 2 2 2 2 2 2 2 2 2 2 2 2 2 2 2 2 2 2 2 2 2 2 2 2 2 2 2 2 
2 2 18 0 0 0 0 0 0 0 0 0 0 0 0 0 0 0 0 0 0 0 0 0 0 0 0 0 0 0 0 0 0 0 0 0 0 0 0 0 0 0 0 0 0 0 0 0 0 0 0 0 0 0 0 0 0 0 0 0 0 0 0 0 0 0 0 0 0 0 0 0 0 0 0 0 0 0 0 0 0 85 11 11 11 11 11 11 11 11 11 11 11 11 11 11 11 11 11 12 2 2 2 2 2 2 2 2 2 2 2 2 2 2 2 2 2 2 2 2 
2 2 18 0 0 0 0 0 0 0 0 0 0 0 0 0 0 0 0 0 0 0 0 0 0 0 0 0 0 0 0 0 0 0 0 0 0 0 0 0 0 0 0 0 0 0 0 0 0 0 0 0 0 0 0 0 0 0 0 0 0 0 0 0 0 0 0 0 0 0 0 0 0 0 0 0 0 0 0 0 0 0 0 0 0 0 0 0 0 0 0 0 0 0 0 0 0 0 0 27 2 2 2 2 2 2 2 2 2 2 2 2 2 2 2 2 2 2 2 2 
2 2 33 34 64 0 0 0 0 0 0 0 0 0 0 0 0 0 0 0 0 0 0 0 0 0 0 0 0 0 0 0 0 0 0 0 0 0 0 0 0 0 0 0 0 0 0 0 0 0 0 0 0 0 0 0 0 0 0 0 0 0 0 0 0 0 0 0 0 0 0 0 0 0 0 0 0 0 0 0 0 0 0 0 0 0 0 0 0 0 0 0 0 0 0 0 0 0 0 27 2 2 2 2 2 2 2 2 2 2 2 2 2 2 2 2 2 2 2 2 
2 2 3 4 79 0 0 0 0 0 0 0 0 0 0 0 0 0 0 0 0 0 0 0 0 0 0 0 0 0 0 0 0 0 0 0 0 0 0 0 0 0 0 0 0 0 0 0 0 0 0 0 0 0 0 0 0 0 0 0 0 0 0 0 0 0 0 0 0 0 0 0 0 0 0 0 0 0 0 0 0 0 0 0 0 0 0 0 0 0 0 0 0 0 0 0 0 0 0 85 11 11 11 11 11 12 2 2 2 2 2 2 2 2 2 2 2 2 2 2 
2 2 18 0 0 0 0 0 0 0 0 0 0 0 0 0 0 0 0 0 0 0 0 0 0 0 0 0 0 0 0 0 0 0 0 0 0 63 34 64 0 0 0 0 0 0 0 0 0 0 0 0 0 0 0 0 0 0 63 34 64 0 0 0 0 0 0 0 0 0 0 0 0 0 0 0 70 41 71 0 0 0 0 0 0 0 0 0 0 0 0 0 0 0 0 0 0 0 0 0 0 0 0 0 0 27 2 2 2 2 2 2 2 2 2 2 2 2 2 2 
2 2 18 0 0 0 0 48 50 0 0 0 0 63 34 64 0 0 0 0 0 0 0 0 0 0 0 0 0 0 0 0 0 0 0 0 0 20 2 18 0 0 0 0 0 0 0 0 0 0 0 0 0 0 0 0 0 0 20 2 18 0 0 0 0 0 0 0 0 0 0 0 0 0 0 0 27 2 25 0 0 0 0 0 0 0 0 0 0 0 0 0 0 0 0 0 0 0 0 0 0 0 0 0 0 27 2 2 2 2 2 2 2 2 2 2 2 2 2 2 
2 2 18 0 0 0 0 0 0 0 0 0 0 20 2 18 0 0 0 0 0 0 0 0 0 0 0 0 0 0 0 0 0 0 0 0 0 20 2 18 0 0 0 0 0 0 0 0 0 0 0 0 0 0 0 0 0 0 20 2 18 0 0 0 0 0 0 0 0 0 0 0 0 0 0 0 27 2 25 0 0 0 0 0 0 0 0 0 0 0 0 0 0 0 0 0 0 0 0 0 0 0 0 0 0 85 11 11 11 11 11 11 11 11 11 11 11 11 12 2 
2 2 18 0 0 0 0 0 0 0 0 0 0 20 2 18 0 0 0 48 49 50 0 0 0 0 0 0 0 0 0 48 49 50 0 0 0 20 2 18 0 0 0 48 50 0 0 0 0 0 0 0 0 48 50 0 0 0 20 2 18 0 0 0 26 0 0 0 0 0 0 0 26 0 0 0 27 2 25 0 0 70 41 71 0 0 0 0 0 0 0 0 0 0 0 0 0 0 0 70 41 71 0 0 0 0 0 0 0 0 0 0 0 0 0 0 0 0 27 2 
2 2 18 0 0 0 0 0 0 0 0 63 34 35 2 18 0 0 0 0 0 0 0 0 0 0 0 0 0 0 0 0 0 0 0 0 0 20 2 18 0 0 0 0 0 0 0 0 0 0 0 0 0 0 0 0 0 0 20 2 18 0 0 0 0 0 0 0 0 0 0 0 0 0 0 0 27 2 25 0 0 27 2 25 0 0 0 0 0 0 0 0 0 0 0 0 0 0 0 27 2 25 0 0 0 0 0 0 0 0 0 0 0 0 0 0 0 0 27 2 
2 2 18 0 0 0 0 0 0 0 0 78 4 5 2 18 0 0 0 0 0 0 0 0 0 0 0 0 0 0 0 0 0 0 0 0 0 20 2 18 0 0 0 0 0 0 0 0 0 0 0 0 0 0 0 0 0 0 20 2 18 0 0 0 0 0 0 0 0 0 0 0 0 0 0 0 27 2 25 0 0 27 2 25 0 0 0 0 0 0 0 0 0 0 0 0 0 0 0 27 2 25 0 0 0 0 0 0 0 0 0 0 0 0 0 0 0 0 27 2 
2 2 18 0 0 0 0 0 0 0 0 0 0 20 2 18 0 0 0 0 0 0 0 0 0 48 49 50 0 0 0 0 0 0 0 0 0 20 2 18 0 0 0 0 0 0 0 0 48 50 0 0 0 0 0 0 0 0 20 2 18 0 0 0 0 0 0 0 26 0 0 0 0 0 0 0 27 2 25 0 0 27 2 25 0 0 0 70 41 71 0 0 0 70 41 71 0 0 0 27 2 40 41 41 41 41 41 71 0 0 0 0 0 0 0 0 0 0 27 2 
2 2 18 0 0 0 0 48 50 0 0 0 0 20 2 18 0 0 0 0 0 0 0 0 0 0 0 0 0 0 0 0 0 0 0 0 0 20 2 18 0 0 0 0 0 0 0 0 0 0 0 0 0 0 0 0 0 0 20 2 18 0 0 0 0 0 0 0 0 0 0 0 0 0 0 0 27 2 25 0 0 27 2 25 0 0 0 27 2 25 0 0 0 27 2 25 0 0 0 27 2 2 2 2 2 2 2 25 0 0 0 0 0 0 0 0 0 0 27 2 
2 2 18 0 0 0 0 0 0 0 0 0 0 20 2 18 0 0 0 65 0 0 0 0 0 0 0 0 0 0 0 0 0 0 0 0 0 20 2 18 0 0 0 0 0 0 0 0 0 0 0 0 0 0 0 0 0 0 20 2 18 0 0 0 0 0 0 0 0 0 0 0 0 0 0 0 27 2 25 0 0 27 2 25 0 0 0 85 11 86 0 0 0 85 11 86 0 0 0 27 2 2 2 2 2 10 11 86 0 0 0 0 0 0 0 0 0 0 27 2 
2 2 18 0 0 0 0 0 0 0 0 0 0 20 2 18 0 0 0 48 49 50 0 0 0 0 0 0 0 0 0 48 49 50 0 0 0 20 2 18 0 0 0 48 50 0 0 0 0 0 0 0 0 48 50 0 0 0 20 2 18 0 0 0 26 0 0 0 0 0 0 0 26 0 0 0 27 2 25 0 0 27 2 25 0 0 0 0 0 0 0 0 0 0 0 0 0 0 0 27 2 2 2 2 2 25 0 0 0 0 0 70 41 41 41 41 41 41 42 2 
2 2 33 34 64 0 0 0 0 0 0 0 0 20 2 18 0 0 0 0 0 0 0 0 0 0 0 0 0 0 0 0 0 0 0 0 0 20 2 18 0 0 0 0 0 0 0 0 0 0 0 0 0 0 0 0 0 0 20 2 18 0 0 0 0 0 0 0 0 0 0 0 0 0 0 0 27 2 25 0 0 27 2 25 0 0 0 0 0 0 0 0 0 0 0 0 0 0 0 27 2 2 2 10 11 86 0 0 0 0 0 27 2 2 2 2 2 2 2 2 
2 2 3 4 79 0 0 0 0 0 0 0 0 20 2 18 0 0 0 0 0 0 0 0 0 0 0 0 0 0 0 0 0 0 0 0 0 20 2 18 0 0 0 0 0 0 0 0 0 0 0 0 0 0 0 0 0 0 20 2 18 0 0 0 0 0 0 0 0 0 0 0 0 0 0 0 27 2 25 0 0 27 2 25 0 0 0 0 0 0 0 0 0 0 0 0 0 0 0 27 2 2 2 25 0 0 0 0 70 71 0 27 2 2 2 2 2 2 2 2 
2 2 18 0 0 0 0 0 0 0 0 0 0 20 2 18 0 0 0 0 0 0 0 0 0 48 49 50 0 0 0 0 0 0 0 0 0 20 2 18 0 0 0 0 0 0 0 0 48 50 0 0 0 0 0 0 0 0 20 2 18 0 0 0 0 0 0 0 26 0 0 0 0 0 0 0 27 2 25 0 0 27 2 40 41 41 41 41 41 41 41 41 41 41 41 41 41 41 41 42 2 10 11 86 0 0 0 0 27 25 0 27 2 2 2 2 2 2 2 2 
2 2 18 0 0 0 0 48 50 0 0 0 0 20 2 18 0 0 0 0 0 0 0 0 0 0 0 0 0 0 0 0 0 0 0 0 0 20 2 18 0 0 0 0 0 0 0 0 0 0 0 0 0 0 0 0 0 0 20 2 18 0 0 0 0 0 0 0 0 0 0 0 0 0 0 0 27 2 25 0 0 27 2 2 2 2 2 2 2 2 2 2 2 2 2 2 2 2 2 2 2 25 0 0 0 0 70 41 42 25 0 27 2 2 2 2 2 2 2 2 
2 2 18 0 0 0 0 0 0 0 0 0 0 20 2 18 0 0 0 0 0 0 0 0 0 0 0 0 0 0 0 0 0 0 0 0 0 20 2 18 0 0 0 0 0 0 0 0 0 0 0 0 0 0 0 0 0 0 20 2 18 0 0 0 0 0 0 0 0 0 0 0 0 0 0 0 27 2 25 0 0 85 11 11 11 11 11 11 11 11 11 11 11 11 11 11 11 11 11 11 11 86 0 0 0 0 27 2 2 25 0 27 2 2 2 2 2 2 2 2 
2 2 18 0 0 0 0 0 0 0 0 0 0 20 2 18 0 0 0 0 0 0 0 0 0 0 0 0 0 0 0 0 0 0 0 0 0 20 2 18 0 0 0 0 0 0 0 0 0 0 0 0 0 0 0 0 0 0 20 2 18 0 0 0 0 0 0 0 0 0 0 0 0 0 0 0 27 2 25 0 0 0 0 0 0 0 0 0 0 0 0 0 0 0 0 0 0 0 0 0 0 0 0 0 70 41 42 2 2 25 0 27 2 2 2 2 2 2 2 2 
2 2 18 0 0 0 0 0 0 0 0 63 34 35 2 18 0 0 0 0 0 0 0 0 0 0 0 0 0 0 0 0 0 0 0 0 0 20 2 18 0 0 0 0 0 0 0 0 0 0 0 0 0 0 0 0 0 0 20 2 18 0 0 0 0 0 0 0 0 0 0 0 0 0 0 0 27 2 25 0 0 0 0 0 0 0 0 0 0 0 0 0 0 0 0 0 0 0 0 0 0 0 0 0 27 2 2 2 2 25 0 27 2 2 2 2 2 2 2 2 
2 2 18 0 0 0 0 0 0 0 0 78 4 5 2 18 0 0 0 0 0 0 0 0 0 0 0 0 0 0 0 0 0 0 0 0 0 20 2 18 0 0 0 0 0 0 0 0 0 0 0 0 0 0 0 0 0 0 20 2 18 0 0 0 0 0 0 0 0 0 0 0 0 0 0 0 27 2 25 0 0 70 41 41 71 0 0 70 41 41 41 71 0 0 70 41 41 41 71 0 0 70 41 41 42 2 2 2 2 25 0 27 2 2 2 2 2 2 2 2 
2 2 18 0 0 0 0 0 0 0 0 0 0 20 2 33 34 34 34 34 34 34 34 34 34 34 34 34 34 34 34 34 34 34 34 34 34 35 2 33 34 34 34 34 34 34 34 34 34 34 34 34 34 34 34 34 34 34 35 2 33 34 34 41 41 41 41 41 41 41 41 41 41 41 41 41 42 2 25 0 0 27 2 2 25 0 0 27 2 2 2 25 0 0 27 2 2 2 25 0 0 27 2 2 2 2 2 2 2 25 0 27 2 2 2 2 2 2 2 2 
2 2 18 0 0 0 0 48 50 0 0 0 0 20 2 2 2 2 2 2 2 2 2 2 2 2 2 2 2 2 2 2 2 2 2 2 2 2 2 2 2 2 2 2 2 2 2 2 2 2 2 2 2 2 2 2 2 2 2 3 4 4 4 11 11 11 11 11 11 11 11 11 11 12 2 2 2 2 25 0 0 27 2 2 40 41 41 42 2 2 2 40 41 41 42 2 2 2 40 41 41 42 2 2 2 2 2 2 2 25 0 27 2 2 2 2 2 2 2 2 
2 2 18 0 0 0 0 0 0 0 0 0 0 20 2 2 2 2 2 2 3 4 4 4 4 4 4 4 4 4 4 5 2 2 3 4 4 4 4 4 4 4 4 4 4 5 2 2 3 4 4 4 4 4 4 4 4 4 4 79 0 0 0 0 0 0 0 0 0 0 0 0 0 85 11 11 11 11 86 0 0 85 11 11 11 11 11 11 11 11 11 11 11 11 11 11 11 11 11 11 11 11 11 12 2 2 2 2 2 25 0 27 2 2 2 2 2 2 2 2 
2 2 18 0 0 0 0 0 0 0 0 0 0 78 4 4 4 4 4 4 79 0 0 0 0 0 0 0 0 0 0 78 4 4 79 0 0 0 0 0 0 0 0 0 0 78 4 4 79 0 0 0 0 0 0 0 0 0 0 0 0 0 0 0 0 0 0 0 0 0 0 0 0 0 0 0 0 0 0 0 0 0 0 0 0 0 0 0 0 0 0 0 0 0 0 0 0 0 0 0 0 0 0 27 2 2 2 2 2 25 0 27 2 2 2 2 2 2 2 2 
2 2 33 34 64 0 0 0 0 0 0 0 0 0 0 0 0 0 0 0 0 0 0 0 0 0 0 0 0 0 0 0 0 0 0 0 0 0 0 0 0 0 0 0 0 0 0 0 0 0 0 0 0 0 0 0 0 0 0 0 0 0 0 0 0 0 0 0 72 0 0 0 0 0 0 0 0 0 0 0 0 0 0 0 0 0 0 0 0 8 0 0 0 0 0 0 0 0 0 0 0 0 0 27 2 2 2 2 2 25 0 27 2 2 2 2 2 2 2 2 
2 2 3 4 79 0 0 0 0 0 0 0 0 0 0 0 0 0 0 0 0 0 0 0 0 0 65 0 0 0 0 0 0 0 0 0 0 0 0 0 0 65 0 0 0 0 0 0 0 0 0 0 0 0 0 0 0 0 0 0 0 0 70 41 41 41 41 41 41 41 71 0 0 0 0 0 0 0 0 0 0 0 0 0 0 0 0 0 0 23 0 0 0 0 0 0 0 0 0 0 0 0 0 27 2 2 2 2 2 25 0 27 2 2 2 2 2 2 2 2 
2 2 18 0 0 0 0 0 0 0 0 0 0 0 0 0 63 64 0 0 0 0 0 0 63 34 34 64 0 0 0 0 0 0 0 0 0 0 63 34 34 64 0 0 0 0 0 0 0 65 0 0 63 34 34 64 0 0 0 0 0 0 85 11 11 11 11 11 11 11 86 0 0 0 0 0 0 0 0 0 0 0 0 0 72 0 0 0 0 38 0 0 0 0 0 0 0 0 0 0 0 0 0 85 11 11 11 11 11 86 0 85 11 11 11 11 11 11 12 2 
2 2 18 0 0 0 0 48 50 0 0 0 0 0 0 0 20 33 34 34 34 34 34 34 35 2 2 33 34 34 34 34 34 34 34 34 34 34 35 2 2 33 34 34 34 34 34 34 34 34 34 34 35 2 2 33 41 41 41 71 0 0 0 0 0 0 0 0 0 0 0 0 0 70 41 71 0 0 0 0 0 0 0 70 41 71 0 0 0 53 0 0 0 0 0 0 0 0 0 0 0 0 0 0 0 0 0 0 0 0 0 0 0 0 0 0 0 0 27 2 
2 2 18 0 0 0 0 0 0 0 0 1 0 0 0 0 20 2 2 3 4 4 4 4 4 4 4 4 4 4 4 4 4 4 4 4 4 4 4 4 4 4 4 4 4 4 4 4 4 4 4 4 4 4 4 4 11 12 2 25 0 0 0 0 0 0 0 0 0 0 0 0 0 27 2 25 0 0 0 0 0 0 0 27 2 25 0 0 0 68 0 0 0 0 0 0 0 0 0 0 0 0 0 0 0 0 0 0 0 0 0 0 0 0 0 0 0 0 27 2 
2 2 18 0 0 0 0 0 0 0 0 16 0 0 0 0 20 2 2 18 0 0 0 0 0 0 0 0 0 0 0 0 0 0 0 0 0 0 0 0 0 0 0 0 0 0 0 0 0 0 0 0 0 0 0 0 0 27 2 40 41 41 41 41 41 41 41 41 41 41 41 41 41 42 2 40 41 41 41 41 41 41 41 42 2 40 41 41 41 41 41 41 41 41 41 41 41 41 41 41 41 41 41 41 41 41 71 0 0 0 0 0 0 0 0 0 0 0 27 2 
2 2 33 34 64 0 0 0 0 0 0 31 0 63 34 34 35 3 4 79 0 0 0 0 0 0 0 0 0 0 0 0 0 0 0 0 0 0 0 0 0 0 0 0 0 0 0 0 0 0 0 0 0 0 0 0 0 85 11 11 11 11 11 11 11 11 11 11 11 11 11 11 11 11 11 11 11 11 11 11 11 11 11 11 11 11 11 11 11 11 11 12 2 2 2 2 2 2 2 2 2 2 2 2 2 2 25 0 0 0 0 0 0 0 0 0 0 0 27 2 
2 2 3 4 79 0 0 0 0 0 0 46 0 20 2 2 2 18 0 0 0 0 0 0 0 0 0 0 0 0 0 0 0 0 0 0 0 0 0 0 0 0 0 0 0 0 0 0 0 65 0 0 0 0 0 0 0 0 0 0 0 0 0 0 0 0 0 0 0 0 0 0 0 0 0 0 0 0 0 0 0 0 0 0 0 0 0 0 0 0 0 27 2 2 2 2 2 2 2 2 2 2 2 2 2 2 40 41 41 71 0 0 0 0 0 0 0 0 27 2 
2 2 18 0 0 0 0 0 0 0 0 61 0 20 2 3 4 79 0 0 0 0 0 0 0 0 0 0 0 0 0 0 0 0 0 0 0 0 0 0 0 0 0 0 0 0 63 34 34 64 0 0 0 0 0 0 0 0 0 0 0 0 0 0 0 0 0 0 0 0 0 0 0 0 0 0 0 0 0 0 0 0 0 0 0 0 0 0 0 0 0 85 11 11 11 11 11 11 11 11 11 11 11 11 11 11 11 11 12 25 0 0 0 0 0 0 0 0 27 2 
2 2 33 34 34 34 34 34 34 34 34 34 34 35 2 18 0 0 0 0 0 0 0 0 0 0 0 0 0 0 0 0 0 0 0 0 0 0 0 1 0 0 0 0 0 0 20 3 4 79 0 0 0 0 0 0 0 0 0 0 0 0 0 0 0 0 0 0 0 0 0 0 0 0 0 0 0 0 0 0 0 0 0 0 0 0 70 41 71 0 0 0 0 0 0 0 0 0 0 0 0 0 0 0 0 0 0 0 27 40 41 71 0 0 0 0 0 0 27 2 
4 4 4 4 4 4 4 4 4 4 4 4 4 4 4 79 0 0 0 0 0 0 0 0 0 0 0 0 0 0 0 0 0 0 0 0 0 0 0 16 0 0 0 0 0 0 20 18 0 0 0 0 0 0 0 0 0 0 0 0 0 0 0 0 0 0 0 0 0 0 0 0 0 0 0 0 0 8 0 0 0 0 0 0 0 0 27 2 25 0 0 0 0 0 0 0 0 0 0 0 0 0 0 0 0 0 0 0 85 11 12 25 0 0 0 0 0 0 27 2 
0 0 0 0 0 0 0 0 0 0 0 0 0 0 0 0 0 0 0 0 0 0 0 63 34 34 64 0 0 0 63 34 34 64 0 0 0 0 0 31 0 0 0 63 34 34 35 18 0 0 0 0 63 34 64 0 0 0 0 0 0 0 0 0 0 0 0 0 0 0 0 0 0 0 0 0 0 23 0 0 0 0 0 0 0 0 27 2 25 0 0 0 55 56 57 0 0 55 56 57 0 0 55 56 57 0 0 0 0 0 27 40 41 71 0 0 0 0 27 2 
0 0 0 0 0 0 0 0 0 0 0 0 0 0 0 0 0 0 0 0 0 0 0 78 4 4 79 0 0 0 78 4 4 79 0 0 0 0 0 46 0 0 0 20 3 4 4 79 0 0 0 0 20 2 18 0 0 0 0 0 0 0 0 0 0 0 0 70 41 41 41 71 0 0 0 0 0 38 0 0 0 55 56 57 0 0 27 2 25 0 0 0 0 0 0 0 0 0 0 0 0 0 0 0 0 0 0 0 0 0 85 11 11 86 0 0 0 0 27 2 
0 0 0 0 0 0 0 0 0 0 0 0 0 0 0 0 0 0 65 0 0 0 0 0 0 0 0 0 0 0 0 0 0 0 0 0 0 0 0 61 0 0 0 20 18 0 0 0 0 0 0 63 35 2 33 34 64 0 0 0 0 0 0 0 0 0 0 85 11 11 11 86 0 0 0 0 0 53 0 0 0 0 0 0 0 0 27 2 25 0 0 0 0 0 0 0 0 0 0 0 0 0 0 0 0 0 0 0 0 0 0 0 0 0 0 0 0 0 27 2 
0 0 0 0 0 0 0 0 0 0 0 0 0 0 0 0 0 63 34 64 0 0 0 0 0 0 0 0 0 0 0 0 0 0 0 0 0 63 34 34 34 34 34 35 18 0 0 0 0 0 0 20 2 2 2 2 18 0 0 0 0 0 65 0 0 0 0 0 0 0 0 0 0 0 0 0 0 68 0 0 0 0 0 0 0 0 27 2 40 41 41 41 41 41 41 41 41 41 41 41 41 41 41 41 41 71 0 0 0 0 0 0 0 0 0 0 70 41 42 2 
0 0 0 0 65 0 0 0 0 0 0 0 0 0 0 0 0 20 2 18 0 0 0 0 0 0 0 63 34 64 0 0 0 0 0 0 0 20 2 2 2 2 2 2 33 34 34 34 34 34 34 35 2 2 2 2 33 34 34 34 34 34 34 64 0 0 0 0 0 0 0 0 0 0 0 70 41 41 41 41 41 41 41 41 41 41 42 2 2 2 2 2 2 2 2 2 2 2 2 2 2 2 2 2 2 25 0 0 0 0 0 0 0 0 0 0 27 2 2 2 
34 34 34 34 34 34 34 34 34 34 34 34 34 34 34 34 34 35 2 18 0 0 0 0 0 0 0 20 2 18 0 0 0 0 0 0 0 20 2 2 2 2 2 2 2 2 2 2 2 2 2 2 2 2 2 2 2 2 2 2 2 2 2 18 0 0 0 0 0 0 0 0 0 0 0 27 2 2 2 2 2 2 2 2 2 2 2 2 2 2 2 2 2 2 2 2 2 2 2 2 2 2 2 2 2 40 41 41 41 41 41 41 41 41 41 41 42 2 2 2 
2 2 2 2 2 2 2 2 2 2 2 2 2 2 2 2 2 2 2 33 34 34 34 34 34 34 34 35 2 33 34 34 34 34 34 34 34 35 2 2 2 2 2 2 2 2 2 2 2 2 2 2 2 2 2 2 2 2 2 2 2 2 2 33 41 41 41 41 41 41 41 41 41 41 41 42 2 2 2 2 2 2 2 2 2 2 2 2 2 2 2 2 2 2 2 2 2 2 2 2 2 2 2 2 2 2 2 2 2 2 2 2 2 2 2 2 2 2 2 2 
2 2 2 2 2 2 2 2 2 2 2 2 2 2 2 2 2 2 2 2 2 2 2 2 2 2 2 2 2 2 2 2 2 2 2 2 2 2 2 2 2 2 2 2 2 2 2 2 2 2 2 2 2 2 2 2 2 2 2 2 2 2 2 2 2 2 2 2 2 2 2 2 2 2 2 2 2 2 2 2 2 2 2 2 2 2 2 2 2 2 2 2 2 2 2 2 2 2 2 2 2 2 2 2 2 2 2 2 2 2 2 2 2 2 2 2 2 2 2 2 